11111111
10001001
10301001
10000001
11111101
10000001
10000001
11200211