111111111111111
100000000000000
100000000000000
100000000000000
100000220220000
100000200020000
100000200000000
100000200020000
100000222220000
111111111111111